A4B: productFamily, deploymentModel, servicecode, termType, usagetype, locationType, location, servicename, deploymentModelDescription
AMAZONROUTE53REGIONALCHINA: productFamily, resourceEndpoint, termType, usagetype, description, locationType, toLocationType, routingTarget, servicecode, groupDescription, routingType, location, servicename, group
AWSAmplify: productFamily, termType, usagetype, datatransferout, locationType, storage, servicecode, instancetype, location, servicename
AWSAppSync: productFamily, termType, usagetype, graphqloperation, locationType, realtimeoperation, cachememorysize, protocol, servicecode, location, servicename, operation
AWSBackup: productFamily, termType, usagetype, locationType, storagetype, servicecode, storageType, location, servicename, operation
AWSBudgets: productFamily, servicecode, groupDescription, termType, usagetype, locationType, location, servicename, operation
AWSCertificateManager: productFamily, termType, usagetype, locationType, type, servicecode, groupDescription, location, servicename, group
AWSCloudFormation: Restriction, servicecode, cloudformationresourceProvider, termType, usagetype, locationType, location, servicename, operation
AWSCloudMap: productFamily, servicecode, termType, usagetype, locationType, location, servicename, type
AWSCloudTrail: productFamily, servicecode, termType, usagetype, locationType, location, insightstype, servicename
AWSCodeArtifact: productFamily, Restriction, servicecode, pricingUnit, termType, usagetype, locationType, location, servicename
AWSCodeCommit: productFamily, servicecode, termType, usagetype, locationType, location, group
AWSCodeDeploy: productFamily, servicecode, termType, usagetype, locationType, location, servicename, operation, deploymentLocation
AWSCodePipeline: productFamily, Restriction, servicecode, termType, usagetype, description, locationType, location, servicename
AWSConfig: productFamily, termType, usagetype, locationType, type, servicecode, location, servicename, category, ciType
AWSCostExplorer: productFamily, requestType, termType, usagetype, locationType, servicecode, granularity, location, servicename, operation
AWSDataExchange: productFamily, volumeType, storageClass, servicecode, termType, usagetype, locationType, location, servicename
AWSDataSync: productFamily, productSchemaDescription, servicecode, termType, usagetype, locationType, location, servicename
AWSDataTransfer: productFamily, fromLocationType, termType, usagetype, toLocationType, toLocation, servicecode, transferType, servicename, fromLocation
AWSDatabaseMigrationSvc: productFamily, volumeType, enhancedNetworkingSupported, memory, dedicatedEbsThroughput, vcpu, termType, locationType, storage, instanceFamily, availabilityZone, storageMedia, physicalProcessor, clockSpeed, networkPerformance, servicename, minVolumeSize, instanceType, usagetype, maxVolumeSize, processorFeatures, Restriction, servicecode, currentGeneration, location, processorArchitecture, operation
AWSDeepRacer: productFamily, servicecode, termType, usagetype, description, locationType, location, servicename, operation
AWSDeveloperSupport: productFamily, whoCanOpenCases, customerServiceAndCommunities, proactiveGuidance, termType, usagetype, includedServices, locationType, training, accountAssistance, thirdpartySoftwareSupport, operationsSupport, servicecode, architectureSupport, programmaticCaseManagement, architecturalReview, technicalSupport, location, caseSeverityresponseTimes, launchSupport, bestPractices
AWSDeviceFarm: productFamily, os, deviceOs, termType, usagetype, description, locationType, executionMode, servicecode, location, servicename, meterMode
AWSDirectConnect: productFamily, fromLocationType, virtualInterfaceType, termType, usagetype, directConnectLocation, locationType, toLocationType, georegioncode, toLocation, version, connectionType, capacity, servicecode, portSpeed, transferType, servicename, location, fromLocation, operation
AWSDirectoryService: productFamily, directoryTypeDescription, directorySize, termType, usagetype, locationType, directoryType, Restriction, servicecode, pricingUnit, location, servicename, operation
AWSELB: productFamily, termType, usagetype, locationType, servicecode, groupDescription, location, servicename, operation, group
AWSElementalMediaConvert: productFamily, transcodingResult, videoQualitySetting, singleOrDualPass, termType, usagetype, addonFeature, locationType, description, videoFrameRate, resolution, codec, frameRate, vqSetting, servicecode, tier, location, servicename, videoResolution, videoCodec
AWSElementalMediaLive: productFamily, termType, usagetype, locationType, reserveType, resolution, videoQuality, output, pipeline, frameRate, input, servicecode, bitRate, location, servicename, operation
AWSElementalMediaPackage: productFamily, servicecode, termType, usagetype, locationType, transferType, location, servicename
AWSElementalMediaStore: productFamily, ingestType, durability, termType, usagetype, description, locationType, availability, storageclass, servicecode, location, servicename, operation
AWSElementalMediaTailor: productFamily, servicecode, termType, usagetype, locationType, location, servicename, operationType
AWSEvents: productFamily, termType, usagetype, locationType, eventType, Restriction, servicecode, location, servicename, operation
AWSFMS: productFamily, servicecode, termType, usagetype, locationType, location, servicename, operation, awsresource
AWSGlobalAccelerator: productFamily, fromLocationType, termType, usagetype, toLocationType, toLocation, dominantnondominant, servicecode, servicename, fromLocation, trafficDirection, operation, clientLocation
AWSGlueElasticViews: productFamily, volumeType, termType, usagetype, locationType, servicecode, groupDescription, location, servicename, operation, group
AWSGlue: productFamily, termType, usagetype, locationType, Restriction, servicecode, location, servicename, operation, group
AWSGreengrass: productFamily, tenancySupport, servicecode, termType, usagetype, locationType, location, servicename, operation
AWSGroundStation: productFamily, bandwidth, termType, usagetype, locationType, servicecode, location, servicename, groundstation, ondemand
AWSIoT1Click: productFamily, deviceType, servicecode, termType, usagetype, locationType, location, servicename, device
AWSIoTAnalytics: productFamily, servicecode, termType, usagetype, locationType, location, servicename, operation, group
AWSIoTEvents: productFamily, awsiotevents, servicecode, termType, usagetype, locationType, location, servicename
AWSIoTSiteWise: productFamily, servicecode, termType, usagetype, locationType, location, servicename, group
AWSIoTThingsGraph: productFamily, servicecode, termType, usagetype, locationType, location, servicename, operation, group
AWSIoT: productFamily, termType, usagetype, locationType, eventType, newcode, protocol, servicecode, location, servicename
AWSLambda: productFamily, termType, usagetype, locationType, Restriction, servicecode, groupDescription, location, servicename, group
AWSMediaConnect: productFamily, fromLocationType, termType, usagetype, locationType, toLocationType, toLocation, reservedTier, servicecode, transferType, location, servicename, fromLocation, operation, flowType
AWSNetworkFirewall: productFamily, servicecode, termType, usagetype, locationType, location, servicename, subcategory, operation
AWSOutposts: productFamily, country, termType, usagetype, locationType, outpostsUnit, servicecode, currentGeneration, paymentOption, location, servicename, paymentTerm
AWSQueueService: productFamily, messageDeliveryOrder, termType, usagetype, locationType, Restriction, servicecode, groupDescription, messageDeliveryFrequency, queueType, location, servicename, group
AWSRoboMaker: productFamily, servicecode, termType, usagetype, locationType, location, servicename, availability, operation
AWSSecretsManager: productFamily, servicecode, termType, usagetype, locationType, location, servicename, group
AWSSecurityHub: productFamily, standardGroup, termType, usagetype, locationType, standardStorage, servicecode, findingSource, location, servicename, findingStorage, findingGroup
AWSServiceCatalog: productFamily, servicecode, termType, usagetype, locationType, location, servicename, operation, withActiveUsers
AWSShield: productFamily, fromLocationType, termType, usagetype, description, locationType, toLocationType, toLocation, servicecode, servicename, location, fromLocation, operation, resourceType
AWSStorageGatewayDeepArchive: productFamily, termType, usagetype, locationType, storageDescription, storageClass, feeDescription, servicecode, feeCode, location, servicename, maximumCapacity, operation
AWSStorageGateway: productFamily, termType, usagetype, locationType, version, storageDescription, Restriction, storageClass, feeDescription, servicecode, feeCode, location, servicename, maximumCapacity
AWSSupportBusiness: productFamily, whoCanOpenCases, customerServiceAndCommunities, proactiveGuidance, termType, usagetype, includedServices, locationType, training, accountAssistance, thirdpartySoftwareSupport, operationsSupport, servicecode, architectureSupport, programmaticCaseManagement, architecturalReview, technicalSupport, location, caseSeverityresponseTimes, launchSupport, bestPractices
AWSSupportEnterprise: productFamily, whoCanOpenCases, customerServiceAndCommunities, proactiveGuidance, termType, usagetype, includedServices, locationType, training, accountAssistance, thirdpartySoftwareSupport, operationsSupport, servicecode, architectureSupport, programmaticCaseManagement, architecturalReview, technicalSupport, location, caseSeverityresponseTimes, launchSupport, bestPractices
AWSSystemsManager: productFamily, dataTransfer, apirequestsfree, parameterType, apirequestspaid, instances, termType, usagetype, changerequestsfree, locationType, storage, updates, gets, changerequestspaid, steps, describes, servicecode, location, servicename, opsItems, throughput
AWSTransfer: productFamily, data, termType, usagetype, locationType, endpoint, servicecode, location, servicename, operation
AWSXRay: productFamily, termType, usagetype, locationType, Restriction, servicecode, groupDescription, location, servicename, operation, group
AlexaTopSites: productFamily, servicecode, termType, usagetype, locationType, location
AlexaWebInfoService: productFamily, servicecode, termType, usagetype, locationType, location
AmazonA2I: productFamily, termType, usagetype, locationType, servicecode, integratingFeature, workforceType, integratingService, location, servicename, operation, integratingApi
AmazonApiGateway: productFamily, termType, usagetype, locationType, description, cacheMemorySizeGb, servicecode, location, servicename, operation
AmazonAppStream: productFamily, osLicenseModel, vcpu, instanceType, termType, usagetype, locationType, instanceFamily, instanceFunction, operatingSystem, videoMemoryGib, Restriction, servicecode, memoryGib, licenseModel, location, servicename, operation
AmazonAthena: productFamily, servicecode, freeQueryTypes, termType, usagetype, description, locationType, location, servicename
AmazonBraket: productFamily, termType, usagetype, locationType, version, producttype, Restriction, operationOutcome, servicecode, provider, location, servicename, devicename, operation
AmazonChimeBusinessCalling: productFamily, messagetype, tocountry, termType, usagetype, locationType, numbertype, servicecode, location, servicename, fromcountry
AmazonChimeCallMe: productFamily, country, servicecode, tocountry, termType, usagetype, locationType, location, servicename
AmazonChimeDialin: productFamily, country, servicecode, callingType, termType, usagetype, locationType, location, servicename
AmazonChimeFeatures: productFamily, primaryplaceofuse, termType, usagetype, locationType, transactiontype, licenseType, servicecode, location, servicename
AmazonChimeVoiceConnector: productFamily, messagetype, tocountry, termType, usagetype, locationType, numbertype, servicecode, location, servicename, fromcountry, calltype
AmazonChime: productFamily, licenseType, servicecode, termType, usagetype, locationType, location, servicename
AmazonCloudDirectory: productFamily, volumeType, termType, usagetype, locationType, Restriction, storageClass, servicecode, groupDescription, location, servicename, group
AmazonCloudFront: productFamily, fromLocationType, requestType, termType, usagetype, locationType, toLocationType, requestDescription, toLocation, servicecode, groupDescription, transferType, location, servicename, fromLocation, operation, group
AmazonCloudSearch: productFamily, instanceType, termType, usagetype, locationType, cloudSearchVersion, servicecode, groupDescription, location, servicename, operation, group
AmazonCloudWatch: productFamily, termType, usagetype, locationType, version, logsDestination, storageMedia, Restriction, alarmType, servicecode, groupDescription, location, servicename, operation, group
AmazonCognitoSync: productFamily, servicecode, termType, usagetype, locationType, location, operation
AmazonCognito: productFamily, Restriction, servicecode, termType, usagetype, locationType, location, servicename, operation
AmazonConnect: productFamily, servicecode, termType, usagetype, channel, locationType, location, servicename
AmazonDAX: productFamily, memory, vcpu, instanceType, termType, usagetype, locationType, instanceFamily, servicecode, currentGeneration, networkPerformance, location, servicename
AmazonDetective: productFamily, servicecode, dataType, termType, usagetype, locationType, location, servicename
AmazonDocDB: productFamily, volumeType, engineCode, enhancedNetworkingSupported, memory, vcpu, termType, locationType, instanceFamily, storageMedia, physicalProcessor, clockSpeed, networkPerformance, servicename, group, minVolumeSize, instanceTypeFamily, instanceType, usagetype, normalizationSizeFactor, maxVolumeSize, databaseEngine, processorFeatures, servicecode, groupDescription, currentGeneration, location, processorArchitecture, operation
AmazonDynamoDB: productFamily, volumeType, OfferingClass, termType, usagetype, locationType, servicecode, groupDescription, LeaseContractLength, location, servicename, PurchaseOption, operation, group
AmazonEC2: instanceCapacityMetal, volumeType, maxIopsvolume, instance, instanceCapacity10xlarge, locationType, toLocationType, instanceFamily, operatingSystem, clockSpeed, LeaseContractLength, ecu, networkPerformance, instanceCapacity8xlarge, group, maxThroughputvolume, gpuMemory, ebsOptimized, maxVolumeSize, gpu, intelAvxAvailable, processorFeatures, instanceCapacity4xlarge, servicecode, groupDescription, elasticGraphicsType, volumeApiName, processorArchitecture, fromLocation, physicalCores, productFamily, fromLocationType, enhancedNetworkingSupported, intelTurboAvailable, memory, dedicatedEbsThroughput, vcpu, OfferingClass, instanceCapacityLarge, capacitystatus, termType, storage, toLocation, intelAvx2Available, storageMedia, physicalProcessor, provisioned, servicename, PurchaseOption, instancesku, productType, instanceCapacity18xlarge, instanceType, tenancy, usagetype, normalizationSizeFactor, instanceCapacity2xlarge, instanceCapacity16xlarge, maxIopsBurstPerformance, instanceCapacity12xlarge, instanceCapacity32xlarge, instanceCapacityXlarge, licenseModel, currentGeneration, preInstalledSw, transferType, location, instanceCapacity24xlarge, instanceCapacity9xlarge, instanceCapacityMedium, operation, resourceType
AmazonECR: productFamily, servicecode, termType, usagetype, locationType, storageType, location, servicename
AmazonECS: productFamily, termType, tenancy, usagetype, locationType, cputype, servicecode, location, servicename, memorytype
AmazonEFS: productFamily, termType, usagetype, locationType, accessType, storageClass, servicecode, throughputClass, location, servicename, operation
AmazonEI: productFamily, termType, usagetype, locationType, acceleratorType, servicecode, acceleratorSize, location, servicename, operation
AmazonEKS: productFamily, termType, tenancy, usagetype, locationType, cputype, tiertype, servicecode, location, servicename, memorytype, operation
AmazonES: productFamily, vcpu, OfferingClass, instanceType, termType, usagetype, locationType, storage, instanceFamily, storageMedia, servicecode, LeaseContractLength, ecu, memoryGib, currentGeneration, location, servicename, PurchaseOption, operation
AmazonETS: productFamily, transcodingResult, servicecode, termType, usagetype, locationType, location, videoResolution
AmazonElastiCache: productFamily, memory, vcpu, OfferingClass, termType, locationType, instanceFamily, storageMedia, LeaseContractLength, networkPerformance, servicename, PurchaseOption, group, instanceType, usagetype, cacheEngine, Restriction, servicecode, groupDescription, currentGeneration, transferType, location, operation
AmazonFSx: productFamily, throughputCapacity, termType, usagetype, locationType, fileSystemType, servicecode, deploymentOption, storageType, location, servicename, operation, cacheType
AmazonForecast: Restriction, servicecode, groupDetails, termType, usagetype, locationType, location, servicename
AmazonGameLift: productFamily, vcpu, instanceType, termType, usagetype, locationType, instanceStorageGb, operatingSystem, Restriction, servicecode, groupDescription, ecu, memoryGib, currentGeneration, location, servicename, operation, dimension, group
AmazonGlacier: productFamily, volumeType, durability, termType, usagetype, locationType, availability, feeDescription, servicecode, groupDescription, feeCode, location, servicename, group
AmazonGuardDuty: productFamily, servicecode, termType, usagetype, locationType, location, servicename, group
AmazonHoneycode: productFamily, usageTier, termType, usagetype, locationType, servicecode, tier, location, servicename, operation

===
EC2
===
/home/cortiz/repos/infra-calc/.venv/bin/python /home/cortiz/repos/infra-calc/infracalc/sandbox.py
Selected EC2 Attributes & Values
================================
  instanceCapacityMetal: 1
  volumeType: Cold HDD, General Purpose, Magnetic, Provisioned IOPS, Throughput Optimized HDD
  maxIopsvolume: 16000, 250 - based on 1 MiB I/O size, 40 - 200, 500 - based on 1 MiB I/O size, 64000
  instance: T2, T3A, T3, T4G
  instanceCapacity10xlarge: 1
  locationType: AWS Local Zone, AWS Region, AWS Wavelength Zone
  toLocationType: AWS Region, Other
  instanceFamily: Compute optimized, FPGA Instances, GPU instance, General purpose, Machine Learning ASIC Instances, Memory optimized, Micro instances, Storage optimized
  operatingSystem: Linux, NA, RHEL, SUSE, Windows
  clockSpeed: 2.0 GHz, 2.3 GHz, 2.4 GHz, 2.5 GHz, 2.6 GHz, 2.8 GHz, 2.9 GHz, 3 GHz, 3.1 GHz, 3.2 GHz, 4 GHz, 4.5 GHz, Up to 3.3 GHz
  LeaseContractLength: 1 yr, 1yr, 3 yr, 3yr
  ecu: 104, 108, 10, 116, 124.5, 128, 12, 132, 139, 13, 14, 168, 16, 174.5, 179, 188, 19, 1, 201, 208, 20, 235, 23, 256, 26, 271, 27, 281, 28, 2, 31, 337, 340, 345, 347, 349, 35, 375, 37, 39, 3, 45, 47, 4, 52, 53.5, 53, 55, 56, 58, 5, 6.5, 62, 64, 70, 73, 7, 88, 8, 91, 97, NA, Variable
  networkPerformance: 10 Gigabit, 100 Gigabit, 12 Gigabit, 15 Gigabit, 20 Gigabit, 25 Gigabit, 40 Gigabit, 400 Gigabit, 50 Gigabit, 75 Gigabit, High, Low to Moderate, Low, Moderate, NA, Up to 10 Gigabit, Up to 15 Gigabit, Up to 25 Gigabit, Up to 5 Gigabit, Very Low
  instanceCapacity8xlarge: 1, 2, 3, 6
  group: CarrierIP:AdditionalAddress, CarrierIP:Address, CarrierIP:Remap, EBS I/O Requests, EBS IOPS Tier 2, EBS IOPS Tier 3, EBS IOPS, EBS Throughput, EBS direct APIs:Get Requests, EBS direct APIs:List Requests, EBS direct APIs:Put Requests, EC2-Dedicated Usage, ELB:Balancer, ELB:Balancing, ElasticIP:AdditionalAddress, ElasticIP:Address, ElasticIP:Remap, NGW:NatGateway
  maxThroughputvolume: 1000 MiB/s, 250 MiB/s, 40 - 90 MB/sec, 500 MiB/s
  gpuMemory: 1 GiB, 2 GiB, 4 GiB, 8 GiB
  ebsOptimized: Yes
  maxVolumeSize: 1 TiB, 16 TiB
  gpu: 16, 1, 2, 4, 8
  intelAvxAvailable: No, Yes
  processorFeatures: AMD Turbo; AVX; AVX2, AVX; AVX2; AMD Turbo, AVX; AVX2; Intel AVX; Intel AVX2; Intel AVX512; Intel Turbo, Intel AVX; Intel AVX2; Intel AVX512; Intel Deep Learning Boost; Intel Turbo, Intel AVX; Intel AVX2; Intel AVX512; Intel Turbo, Intel AVX; Intel AVX2; Intel Turbo, Intel AVX; Intel AVX2, Intel AVX; Intel Turbo
  instanceCapacity4xlarge: 12, 1, 2, 4, 6
  servicecode: AmazonEC2
  groupDescription: Additional Carrier IP address attached to a running instance, Additional Elastic IP address attached to a running instance, Carrier IP address attached to a running instance, Carrier IP address remap, Charge for per GB data processed by NAT Gateways with provisioned bandwidth, Charge for per GB data processed by NatGateways, Charge per Provisioned mbps, Data processed by Elastic Load Balancer, Elastic IP address attached to a running instance, Elastic IP address remap, Fee for running at least one Dedicated Instance in the region, Get Requests for EBS direct APIs, Hourly charge for NAT Gateways, IOPS, Idle Provisioned Application Load Balancer Capacity Units-Hr, Input/Output Operation, List Requests for EBS direct APIs, LoadBalancer hourly usage by Application Load Balancer, LoadBalancer hourly usage by Network Load Balancer, Per hour and per Gbps charge for NAT Gateways with provisioned bandwidth, Put Requests for EBS direct APIs, Standard Elastic Load Balancer, Used Application load balancer capacity units-hr, Used Network load balancer capacity units-hr
  elasticGraphicsType: eg1.2xlarge, eg1.large, eg1.medium, eg1.xlarge
  volumeApiName: gp2, gp3, io1, io2, sc1, st1, standard
  processorArchitecture: 32-bit or 64-bit, 64-bit
  fromLocation: AWS GovCloud (US-West), Asia Pacific (Seoul), Asia Pacific (Singapore), Asia Pacific (Sydney), Asia Pacific (Tokyo), EU (Frankfurt), EU (Ireland), External, South America (Sao Paulo), US East (N. Virginia), US West (N. California), US West (Oregon)
  physicalCores: 0, 16, 20, 224, 24, 36, 48, 64, 6, 72, 96
  productFamily: CPU Credits, Compute Instance (bare metal), Compute Instance, Data Transfer, Dedicated Host, EBS direct API Requests, Elastic Graphics, Fast Snapshot Restore, Fee, IP Address, Load Balancer-Application, Load Balancer-Network, Load Balancer, NAT Gateway, Provisioned Throughput, Storage Snapshot, Storage, System Operation
  fromLocationType: AWS Region, Other
  enhancedNetworkingSupported: No, Yes
  intelTurboAvailable: No, Yes
  memory: 0.5 GiB, 0.613 GiB, 1 GiB, 1.7 GiB, 10.5 GiB, 1152 GiB, 117 GiB, 122 GiB, 12288 GiB, 128 GiB, 144 GiB, 15 GiB, 15.25 GiB, 16 GiB, 160 GiB, 17.1 GiB, 18432 GiB, 192 GiB, 1952 GiB, 2 GiB, 21 GiB, 244 GiB, 24576 GiB, 256 GiB, 3.75 GiB, 30 GiB, 30.5 GiB, 32 GiB, 34.2 GiB, 384 GiB, 3904 GiB, 4 GiB, 42 GiB, 48 GiB, 488 GiB, 5.25 GiB, 512 GiB, 60 GiB, 60.5 GiB, 61 GiB, 6144 GiB, 64 GiB, 68.4 GiB, 7 GiB, 7.5 GiB, 72 GiB, 732 GiB, 768 GiB, 8 GiB, 9216 GiB, 96 GiB, 976 GiB, NA
  dedicatedEbsThroughput: 10 Gbps, 100 Mbps, 1000 Mbps, 10000 Mbps, 1125 Mbps, 12000 Mbps, 13500 Mbps, 13600 Mbps, 14000 Mbps, 1500 Mbps, 1600 Mbps, 1700 Mbps, 1750 Mbps, 18000 Mbps, 19000 Mbps, 2000 Mbps, 2120 Mbps, 2250 Mbps, 2333 Mbps, 2800 Mbps, 28000 Mbps, 28500 Mbps, 30 Gbps, 300 Mbps, 3000 Mbps, 3170 Mbps, 3500 Mbps, 38000 Mbps, 40 Gbps, 400 Mbps, 4000 Mbps, 425 Mbps, 450 Mbps, 4500 Mbps, 4750 Mbps, 5 Gbps, 500 Mbps, 5000 Mbps, 60 Gbps, 600 Mbps, 6000 Mbps, 6300 Mbps, 6800 Mbps, 7000 Mbps, 750 Mbps, 800 Mbps, 850 Mbps, 875 Mbps, 9000 Mbps, 9500 Mbps, Up to 10 Gbps, Up to 12.5 Gbps, Up to 2085 Mbps, Up to 2120 Mbps, Up to 2250 Mbps, Up to 2333 Mbps, Up to 2780 Mbps, Up to 2800 Mbps, Up to 3000 Mbps, Up to 3170 Mbps, Up to 3500 Mbps, Up to 4500 Mbps, Up to 4750 Mbps, Up to 9500 Mbps
  vcpu: 128, 12, 16, 192, 1, 24, 2, 32, 36, 40, 448, 48, 4, 64, 72, 8, 96
  OfferingClass: convertible, standard
  instanceCapacityLarge: 16, 22, 24, 32, 36, 48, 8
  capacitystatus: AllocatedCapacityReservation, AllocatedHost, NA, UnusedCapacityReservation, UsedFFP-C310816-1, UsedFFP-C32D-1, UsedFFP-C33-1, UsedFFP-C33-2, UsedFFP-C330816-1, UsedFFP-C33T21-1, UsedFFP-C33T22-1, UsedFFP-C33T3-1, UsedFFP-C410816-1, UsedFFP-C42-1, UsedFFP-C42-2, UsedFFP-C420816-1, UsedFFP-C42T22-1, UsedFFP-C42T3-1, UsedFFP-C510816-1, UsedFFP-CM33-1, UsedFFP-CM33T22-1, UsedFFP-CM33T3-1, UsedFFP-CM42-1, UsedFFP-CM42T22-1, UsedFFP-CM42T3-1, UsedFFP-CMR33-1, UsedFFP-CMR33T22-1, UsedFFP-CMR33T3-1, UsedFFP-CMR42-1, UsedFFP-CMR42T22-1, UsedFFP-CMR42T3-1, UsedFFP-LAMBDA-1, UsedFFP-M33-1, UsedFFP-M33T22-1, UsedFFP-M33T3-1, UsedFFP-M42-1, UsedFFP-M42T22-1, UsedFFP-M42T3-1, UsedFFP-R32-1, UsedFFP-R32T22-1, UsedFFP-R33-1, UsedFFP-R33T22-1, UsedFFP-R33T3-1, UsedFFP-R42-1, UsedFFP-R42T22-1, UsedFFP-R42T3-1, UsedFFP-T22-1, Used
  termType: OnDemand, Reserved
  storage: 1 x 100 NVMe SSD, 1 x 118 NVMe SSD, 1 x 120 SSD, 1 x 1250 NVMe SSD, 1 x 150 NVMe SSD, 1 x 160 SSD, 1 x 1900 NVMe SSD, 1 x 1920 SSD, 1 x 200 NVMe SSD, 1 x 2000 HDD, 1 x 237 NVMe SSD, 1 x 240 SSD, 1 x 2500 NVMe SSD, 1 x 300 NVMe SSD, 1 x 32 SSD, 1 x 320 SSD, 1 x 350 SSD, 1 x 4 SSD, 1 x 400 NVMe SSD, 1 x 410 SSD, 1 x 420 SSD, 1 x 450 NVMe SSD, 1 x 470 NVMe SSD, 1 x 475 NVMe SSD, 1 x 480 SSD, 1 x 50 NVMe SSD, 1 x 59 NVMe SSD, 1 x 60 SSD, 1 x 75 NVMe SSD, 1 x 7500 NVMe SSD, 1 x 80 SSD, 1 x 800 SSD, 1 x 850 SSD, 1 x 900 NVMe SSD, 1 x 940 NVMe SSD, 1 x 950 NVMe SSD, 1 x 960 SSD, 12 x 14000 HDD, 12 x 2000 HDD, 1200 GB NVMe SSD, 125 GB NVMe SSD, 16 x 14000 HDD, 2 x 120 SSD, 2 x 1200 NVMe SSD, 2 x 14000 HDD, 2 x 1425 NVMe SSD, 2 x 16 SSD, 2 x 160 SSD, 2 x 1900 NVMe SSD, 2 x 1920 SSD, 2 x 2000 HDD, 2 x 2500 NVMe SSD, 2 x 300 NVMe SSD, 2 x 320 SSD, 2 x 40 SSD, 2 x 420 SSD, 2 x 600 NVMe SSD, 2 x 7500 NVMe SSD, 2 x 80 SSD, 2 x 800 SSD, 2 x 840 SSD, 2 x 900 GB NVMe SSD, 2 x 900 NVMe SSD, 225 GB NVMe SSD, 24 x 14000 HDD, 24 x 2000 HDD, 2400 GB NVMe SSD, 3 x 2000 HDD, 32 x 2000 NVMe SSD, 4 x 14000 HDD, 4 x 1900 NVMe SSD, 4 x 2000 HDD, 4 x 420 SSD, 4 x 600 NVMe SSD, 4 x 7500 NVMe SSD, 4 x 800 SSD, 4 x 840 SSD, 4 x 900 NVMe SSD, 4 x 940 NVMe SSD, 6 x 2000 HDD, 600 GB NVMe SSD, 8 x 1000 SSD, 8 x 14000 HDD, 8 x 1900 NVMe SSD, 8 x 2000 HDD, 8 x 7500 NVMe SSD, 8 x 800 SSD, 900 GB NVMe SSD, EBS only, NA
  toLocation: AWS GovCloud (US-West), Asia Pacific (Seoul), Asia Pacific (Singapore), Asia Pacific (Sydney), Asia Pacific (Tokyo), EU (Frankfurt), EU (Ireland), External, South America (Sao Paulo), US East (N. Virginia), US West (N. California), US West (Oregon)
  intelAvx2Available: No, Yes
  storageMedia: Amazon S3, HDD-backed, SSD-backed
  physicalProcessor: AMD EPYC 7571, AMD EPYC 7R32, AWS Graviton Processor, AWS Graviton2 Processor, High Frequency Intel Xeon E7-8880 v3 (Haswell), Intel Core i7-8700B CPU, Intel Skylake E5 2686 v5, Intel Xeon E5-2650, Intel Xeon E5-2666 v3 (Haswell), Intel Xeon E5-2670 (Sandy Bridge), Intel Xeon E5-2670 v2 (Ivy Bridge), Intel Xeon E5-2670 v2 (Ivy Bridge/Sandy Bridge), Intel Xeon E5-2670, Intel Xeon E5-2676 v3 (Haswell), Intel Xeon E5-2680 v2 (Ivy Bridge), Intel Xeon E5-2686 v4 (Broadwell), Intel Xeon Family, Intel Xeon Platinum 8124M, Intel Xeon Platinum 8151, Intel Xeon Platinum 8175 (Skylake), Intel Xeon Platinum 8252, Intel Xeon Platinum 8259 (Cascade Lake), Intel Xeon Platinum 8275CL (Cascade Lake), Intel Xeon Platinum 8275L, Intel Xeon Platinum 8280L (Cascade Lake), Intel Xeon Scalable (Skylake), Variable
  provisioned: No, Yes
  servicename: Amazon Elastic Compute Cloud
  PurchaseOption: All Upfront, AllUpfront, No Upfront, NoUpfront, Partial Upfront, PartialUpfront
  instancesku: 222FSQ7X57S9DN65, 222ZN72EQSMT9B4R, 22354X8P2RQG2RB4, 223BX6UNNB3JE9ET, 224367QE5DEDFDMY, 224Z6YMJJVNJ2VPT, 225EZ9XY8Y56GSQ2, 225FC8WWTDXCN5YY, 225PBVYAH3FKDTPC, 225VHP638VU7UNUV, 22648K2ZMPHKNRU5, 2269AMP5XAJAGDWB, 226JGRK7TWUDF9N7, 226XRGV3EJ846UH4, 2273U95BN3KDJUMQ, 227UWXZAGWD6NCYB, 228AGUHXUG9S37M5, 228DF3SPG7CVN75X, 228FUYA9JNAWK58N, 228QQBN7P8WX26JP, 228W7ASGCKFPF4JP, 229DTHTWCNQNFUE2, 229JMAKMSF5PP9B8, 229MHNQNYD47XV62, 22BY823JMH3UZ9AS, 22C69976ZCBAR5Z8, 22CEBRHAC9JMH5RW, 22CG84CZ4UY44YTZ, 22DEYJDBWNK2Y66H, 22E7AGVBQ9AD2NZH, 22ES8S36B7P28G6N, 22FNUXK53UZYPS8U, 22FYP5DJC22Y9QGZ, 22GEDF5EM8BA53C8, 22GVT7XDZGXNUUNX, 22GX4XPWSPHNYD4T, 22HY3U7V924JK8FW, 22JG7JCSTG3SEXBW, 22JWDC7RXS25WET8, 22JYNGEXXSQ6GG3F, 22M6GN63KMYZUBDV, 22M92URJGUUH9FER, 22M9YTXBFU2NZT63, 22N99VZ9PT3KQRCV, 22NDBYCS3YCDKY68, 22NF4B9ECKE2QESH, 22NNFPH4XF5VJ6K9, 22NNVCTS68DC85YD, 22NS8HYQFVJPTC2K, 22NUYNPVHVFA76X4, 22PCVUMSTSHECWJD, 22QF28GZHFX2TZG3, 22QMJY32MBA2EC83, 22QTTQVCVSG6SNU2, 22RSZYA8BPYPQZCT, 22RWZH756M9RGXWR, 22S67HZKK9QJEP96, 22SBKEJ8F25GCA2X, 22SD4ZZ3RBHUHMA6, 22SG49KEQGWZ4FMC, 22SQPBYQU72RGA4J, 22T5YMSA9M9KAP5N, 22TEQ9S9JZ7SW43X, 22TKR7CHZX8UH3MF, 22TYKKZ2ARVPQ9TZ, 22U7W8SAZRK87C5J, 22UHKCPHFZTMSD24, 22URS9SX64VC8ZQ4, 22UW8BDDE6833Q4S, 22VE92YBURZ3GTPW, 22VH9YQUDAPH6JJR, 22VPGB87R2NZ8A4A, 22VPUDMF62JJ5EWD, 22VX7P8RHPQXWRQ9, 22VZGTW74BNSBAEN, 22W9DF64VGYG4PFD, 22WWT9NA9N9VM88G, 22WZQDR6P5JFFP6Z, 22XBSF5QFVFX722A, 22XC6VYPRKQUC8CY, 22XWCNF55869ADUD, 22XXZPFEYGHV5VHF, 22Y8XZ4D86PF4NRK, 22YNAUFUQ4BQJVTM, 22YW488HK9SD28WC, 22YZ5VXUV2P7YUAP, 22ZRJEWY9DES43QY, 2323K9V63ASGGT2E, 232FKKTDQWWWDHFV, 232HBNWV3JCXJPXM, 232SA2UJZQEAVZDG, 232TQUDQV7MKCKF8, 232VUUP7CZTPF3XB, 233C49V5KBYM2C5S, 233M9296CRK6CDBW, 233SM6UUY2Z3JY9E, 234TRXDPEDZSNNPS, 234U4R8QC7WRBTD6, 2352RQQ4QGJQ6VWZ, 235X9N559HH62ZYD
  productType: Base
  instanceCapacity18xlarge: 1
  instanceType: a1.2xlarge, a1.4xlarge, a1.large, a1.medium, a1.metal, a1.xlarge, a1, c1.medium, c1.xlarge, c3.2xlarge, c3.4xlarge, c3.8xlarge, c3.large, c3.xlarge, c3, c4.2xlarge, c4.4xlarge, c4.8xlarge, c4.large, c4.xlarge, c4, c5.12xlarge, c5.18xlarge, c5.24xlarge, c5.2xlarge, c5.4xlarge, c5.9xlarge, c5.large, c5.metal, c5.xlarge, c5, c5a.12xlarge, c5a.16xlarge, c5a.24xlarge, c5a.2xlarge, c5a.4xlarge, c5a.8xlarge, c5a.large, c5a.xlarge, c5ad.12xlarge, c5ad.16xlarge, c5ad.24xlarge, c5ad.2xlarge, c5ad.4xlarge, c5ad.8xlarge, c5ad.large, c5ad.xlarge, c5d.12xlarge, c5d.18xlarge, c5d.24xlarge, c5d.2xlarge, c5d.4xlarge, c5d.9xlarge, c5d.large, c5d.metal, c5d.xlarge, c5d, c5n.18xlarge, c5n.2xlarge, c5n.4xlarge, c5n.9xlarge, c5n.large, c5n.metal, c5n.xlarge, c5n, c6g.12xlarge, c6g.16xlarge, c6g.2xlarge, c6g.4xlarge, c6g.8xlarge, c6g.large, c6g.medium, c6g.metal, c6g.xlarge, c6g, c6gd.12xlarge, c6gd.16xlarge, c6gd.2xlarge, c6gd.4xlarge, c6gd.8xlarge, c6gd.large, c6gd.medium, c6gd.metal, c6gd.xlarge, c6gd, c6gn.12xlarge, c6gn.16xlarge, c6gn.2xlarge, c6gn.4xlarge, c6gn.8xlarge, c6gn.large, c6gn.medium, c6gn.metal, c6gn.xlarge, c6gn, cc2.8xlarge, cr1.8xlarge, d2.2xlarge, d2.4xlarge, d2.8xlarge
  tenancy: Dedicated, Host, NA, Reserved, Shared
  usagetype: AFS1-BoxUsage:c5.12xlarge, AFS1-BoxUsage:c5.18xlarge, AFS1-BoxUsage:c5.24xlarge, AFS1-BoxUsage:c5.2xlarge, AFS1-BoxUsage:c5.4xlarge, AFS1-BoxUsage:c5.9xlarge, AFS1-BoxUsage:c5.large, AFS1-BoxUsage:c5.metal, AFS1-BoxUsage:c5.xlarge, AFS1-BoxUsage:c5d.12xlarge, AFS1-BoxUsage:c5d.18xlarge, AFS1-BoxUsage:c5d.24xlarge, AFS1-BoxUsage:c5d.2xlarge, AFS1-BoxUsage:c5d.4xlarge, AFS1-BoxUsage:c5d.9xlarge, AFS1-BoxUsage:c5d.large, AFS1-BoxUsage:c5d.metal, AFS1-BoxUsage:c5d.xlarge, AFS1-BoxUsage:d2.2xlarge, AFS1-BoxUsage:d2.4xlarge, AFS1-BoxUsage:d2.8xlarge, AFS1-BoxUsage:d2.xlarge, AFS1-BoxUsage:g4dn.12xlarge, AFS1-BoxUsage:g4dn.16xlarge, AFS1-BoxUsage:g4dn.2xlarge, AFS1-BoxUsage:g4dn.4xlarge, AFS1-BoxUsage:g4dn.8xlarge, AFS1-BoxUsage:g4dn.metal, AFS1-BoxUsage:g4dn.xlarge, AFS1-BoxUsage:i3.16xlarge, AFS1-BoxUsage:i3.2xlarge, AFS1-BoxUsage:i3.4xlarge, AFS1-BoxUsage:i3.8xlarge, AFS1-BoxUsage:i3.large, AFS1-BoxUsage:i3.metal, AFS1-BoxUsage:i3.xlarge, AFS1-BoxUsage:m5.12xlarge, AFS1-BoxUsage:m5.16xlarge, AFS1-BoxUsage:m5.24xlarge, AFS1-BoxUsage:m5.2xlarge, AFS1-BoxUsage:m5.4xlarge, AFS1-BoxUsage:m5.8xlarge, AFS1-BoxUsage:m5.large, AFS1-BoxUsage:m5.metal, AFS1-BoxUsage:m5.xlarge, AFS1-BoxUsage:m5d.12xlarge, AFS1-BoxUsage:m5d.16xlarge, AFS1-BoxUsage:m5d.24xlarge, AFS1-BoxUsage:m5d.2xlarge, AFS1-BoxUsage:m5d.4xlarge, AFS1-BoxUsage:m5d.8xlarge, AFS1-BoxUsage:m5d.large, AFS1-BoxUsage:m5d.metal, AFS1-BoxUsage:m5d.xlarge, AFS1-BoxUsage:r5.12xlarge, AFS1-BoxUsage:r5.16xlarge, AFS1-BoxUsage:r5.24xlarge, AFS1-BoxUsage:r5.2xlarge, AFS1-BoxUsage:r5.4xlarge, AFS1-BoxUsage:r5.8xlarge, AFS1-BoxUsage:r5.large, AFS1-BoxUsage:r5.metal, AFS1-BoxUsage:r5.xlarge, AFS1-BoxUsage:r5d.12xlarge, AFS1-BoxUsage:r5d.16xlarge, AFS1-BoxUsage:r5d.24xlarge, AFS1-BoxUsage:r5d.2xlarge, AFS1-BoxUsage:r5d.4xlarge, AFS1-BoxUsage:r5d.8xlarge, AFS1-BoxUsage:r5d.large, AFS1-BoxUsage:r5d.metal, AFS1-BoxUsage:r5d.xlarge, AFS1-BoxUsage:t3.2xlarge, AFS1-BoxUsage:t3.large, AFS1-BoxUsage:t3.medium, AFS1-BoxUsage:t3.micro, AFS1-BoxUsage:t3.nano, AFS1-BoxUsage:t3.small, AFS1-BoxUsage:t3.xlarge, AFS1-BoxUsage:x1.16xlarge, AFS1-BoxUsage:x1.32xlarge, AFS1-BoxUsage:x1e.16xlarge, AFS1-BoxUsage:x1e.2xlarge, AFS1-BoxUsage:x1e.32xlarge, AFS1-BoxUsage:x1e.4xlarge, AFS1-BoxUsage:x1e.8xlarge, AFS1-BoxUsage:x1e.xlarge, AFS1-CPUCredits:t3, AFS1-DataProcessing-Bytes, AFS1-DedicatedRes:c5.12xlarge, AFS1-DedicatedRes:c5.18xlarge, AFS1-DedicatedRes:c5.24xlarge, AFS1-DedicatedRes:c5.2xlarge, AFS1-DedicatedRes:c5.4xlarge, AFS1-DedicatedRes:c5.9xlarge, AFS1-DedicatedRes:c5.large, AFS1-DedicatedRes:c5.metal, AFS1-DedicatedRes:c5.xlarge, AFS1-DedicatedRes:c5d.12xlarge, AFS1-DedicatedRes:c5d.18xlarge
  normalizationSizeFactor: 0.25, 0.5, 128, 144, 16, 192, 1, 24, 256, 2, 32, 48, 4, 64, 72, 80, 8, 96, NA
  instanceCapacity2xlarge: 12, 2, 4, 5, 6, 8
  instanceCapacity16xlarge: 1, 2
  maxIopsBurstPerformance: 3000 for volumes <= 1 TiB, Hundreds
  instanceCapacity12xlarge: 1, 2
  instanceCapacity32xlarge: 1
  instanceCapacityXlarge: 11, 12, 16, 18, 24, 4, 8
  licenseModel: Bring your own license, NA, No License required
  currentGeneration: No, Yes
  preInstalledSw: NA, SQL Ent, SQL Std, SQL Web
  transferType: AWS Inbound, AWS Outbound, InterRegion Inbound, InterRegion Outbound, IntraRegion
  location: AWS GovCloud (US-East), AWS GovCloud (US-West), Africa (Cape Town), Asia Pacific (Hong Kong), Asia Pacific (KDDI) - Tokyo, Asia Pacific (Mumbai), Asia Pacific (Osaka-Local), Asia Pacific (SKT) - Daejeon, Asia Pacific (Seoul), Asia Pacific (Singapore), Asia Pacific (Sydney), Asia Pacific (Tokyo), Canada (Central), EU (Frankfurt), EU (Ireland), EU (London), EU (Milan), EU (Paris), EU (Stockholm), Middle East (Bahrain), South America (Sao Paulo), US East (Boston), US East (Houston), US East (Miami), US East (N. Virginia), US East (Ohio), US East (Verizon) - Atlanta, US East (Verizon) - Boston, US East (Verizon) - Dallas, US East (Verizon) - Miami, US East (Verizon) - New York, US East (Verizon) - Washington DC, US West (Los Angeles), US West (N. California), US West (Oregon), US West (Verizon) - Denver, US West (Verizon) - Las Vegas, US West (Verizon) - San Francisco Bay Area, US West (Verizon) - Seattle
  instanceCapacity24xlarge: 1
  instanceCapacity9xlarge: 2
  instanceCapacityMedium: 16, 32
  operation: EnableFastSnapshotRestore, Hourly, LoadBalancing:Application, LoadBalancing:Network, LoadBalancing, NatGateway, RunInstances:0002, RunInstances:0004, RunInstances:0006, RunInstances:000g, RunInstances:0010, RunInstances:0100, RunInstances:0102, RunInstances:0200, RunInstances:0202, RunInstances:0800, RunInstances:FFP-C310816-1, RunInstances:FFP-C32D-1, RunInstances:FFP-C33-1, RunInstances:FFP-C33-2, RunInstances:FFP-C330816-1, RunInstances:FFP-C33T21-1, RunInstances:FFP-C33T22-1, RunInstances:FFP-C33T3-1, RunInstances:FFP-C410816-1, RunInstances:FFP-C42-1, RunInstances:FFP-C42-2, RunInstances:FFP-C420816-1, RunInstances:FFP-C42T22-1, RunInstances:FFP-C42T3-1, RunInstances:FFP-C510816-1, RunInstances:FFP-CM33-1, RunInstances:FFP-CM33T22-1, RunInstances:FFP-CM33T3-1, RunInstances:FFP-CM42-1, RunInstances:FFP-CM42T22-1, RunInstances:FFP-CM42T3-1, RunInstances:FFP-CMR33-1, RunInstances:FFP-CMR33T22-1, RunInstances:FFP-CMR33T3-1, RunInstances:FFP-CMR42-1, RunInstances:FFP-CMR42T22-1, RunInstances:FFP-CMR42T3-1, RunInstances:FFP-LAMBDA-1, RunInstances:FFP-M33-1, RunInstances:FFP-M33T22-1, RunInstances:FFP-M33T3-1, RunInstances:FFP-M42-1, RunInstances:FFP-M42T22-1, RunInstances:FFP-M42T3-1, RunInstances:FFP-R32-1, RunInstances:FFP-R32T22-1, RunInstances:FFP-R33-1, RunInstances:FFP-R33T22-1, RunInstances:FFP-R33T3-1, RunInstances:FFP-R42-1, RunInstances:FFP-R42T22-1, RunInstances:FFP-R42T3-1, RunInstances:FFP-T22-1, RunInstances, Surcharge, T2CPUCredits, T3ACPUCredits, T3CPUCredits, T4GCPUCredits, WindowsT2CPUCredits, WindowsT3ACPUCredits, WindowsT3CPUCredits
  resourceType: Get:Snapshot, List:Snapshot, Put:Snapshot

Process finished with exit code 0
